XXXXXXXXX
X     X X
X X    XX
X    X  X
XXXXXXXXX
start 1, 1
end 6, 3